F 0,102,0
                NO img/north.xpm


                        SO img/south.xpm


                                  WE img/west.xpm

EA img/east.xpm

C 0,0,255


        1111111111111111111111111
        1100000000110000000000001
        1001000001110000000000001
        1001000000000000000000001
111111111011000001110000000000011
100000000011000001110111111111111
11110111111111011100000010001
11110111111111011101010010001         
11000000110101001100000010001    
10010100000000000100000010001                                  
10000000000000010001010010001
11010101101101011101011000001                   
11N10101 1110101 101000010001
11111111 1111111 111111111111
