F 255,1,12





                NO img/path_to_the_north_texture


         
                        SO ./img/path_to_the_south_texture
                                  WE img/path_to_the_west_texture





EA img/path_to_the_east_texture




C 225,0,0



        1111111111111111111111111
        1100000000110000000000001
        1001000001110000000000001
        1001000000000000000000001
111111111011000001110000000000011
1000000000110000011101111111111
11110111111111011100000010001
11110111111111011101010010001
11000000110101001100000010001
10010100000000000100000010001
1000N000000000010001010010001
11010101101101011101011000001       
11010101 1110101 101000010001
11111111 1111111 111111111111